$$$$$$$$$$$$$$$$$$$$$$
$$##################$$
$$##################$$
$$..................$$
$$..................$$
$$......==.==.......$$
$$......==.==.......$$
$$......--.--.......$$
$$.......@..?.......$$
$$..................$$
$$..................$$
$$$$$$$$$00$$$$$$$$$$$
$$$$$$$$$00$$$$$$$$$$$